to my collection	a mi colección					
there are still vices to perfect	aún quedan vicios por perfeccionar					
dance like a bow on a fan	bailar como un lazo en un ventilador					
to wear out	cansar					
with the emperor’s new suit	con el traje nuevo del emperador					
with the tip of the shoe	con la punta del zapato					
of medals and scratches	de medallas y de arañazos					
discover a profile	descubran un perfil					
say what you see	di que ves					
tell me what you see	dime que ves					
the future got dressed	el futuro se vistió					
in the rare days	en los días raros					
between the hands	entre las manos					
there are so many idiots out there	hay tanto idiota ahí fuera					
to throw	lanzar					
coins that when turning	monedas que al girar					
there are no wise men	no hay reyes magos					
no deal	no hay trato					
we will uncover in the intimacy	nos destaparemos en la intimidad					
we have many more left	nos quedan muchos más					
in order to do it my way	por hacerlo a mi manera					
anxiety can grind me down	puede comerme la ansiedad					
I might make a habit of anger	puede ser que haga de la rabia mi flor					
maybe I make a habit of anger	puede ser que haga de la rabia mi flor					
maybe tomorrow I conceal my voice	puede ser que mañana esconda mi voz					
I can destroy	puedo arrasar					
I can be quiet	puedo callar					
I may wear out	puedo cansar					
I can do harm	puedo doler					
I can be charming	puedo encantar					
I’m able to escape	puedo escapar					
I’m able to dodge	puedo escurrir					
I’m able to pretend that I don’t care	puedo fingir que me da igual					
I’m able to force reality	puedo forzar la realidad					
I’m able to turn	puedo girar					
I’m able to insist	puedo incidir					
I’m able to piss off	puedo joder					
I’m able to throw	puedo lanzar					
I’m able to call you without a single word	puedo llamarte sin hablar					
I may bite the dust	puedo palmar					
I’m able to split myself and negotiate the other half	puedo partirme y negociar la otra mitad					
I may get lost in the obvious	puedo perderme en la obviedad					
I’m able to break, I’m able to forget	puedo romper puedo olvidar					
I do know that, without all of you, this hurts more	puedo saber que sin vosotros duele más					
I’m able to get out	puedo salir					
I do know when I’ve reached my limit	puedo sentir que no doy más					
I may be deceived easily	puedo ser fácil de engañar					
I may be helpful	puedo servir					
I’m able to twist	puedo torcer					
I’m able to win	puedo vencer					
I’m able to return	puedo volver					
that without blur	que sin borrón					
that without coal	que sin carbón					
who would say	quien iba a decir					
who saw it	quien lo vio					
regroup pieces	reagrupar pedazos					
gifts to open	regalos por abrir					
to be helpful	servir					
if there is something	si hay algo					
tune in	sintonizar					
every man for himself	sálvese quien pueda					
touch tune, define stroke	toca afinar definir el trazo					
a brief and fleeting spring	un manantial breve y fugaz					
and ends in echo	y acaba en eco					
and, with it, my flag	y con ella mi bandera					
and the cellophane begins	y ernpieza el celofán					
it is already here	ya está aquí					
open it slowly	ábrelo despacio					
"<style type=""text/css""> p, li { white-space: pre-wrap; } </style> <p style="" margin-top:0px; margin-bottom:0px; margin-left:0px; margin-right:0px; -qt-block-indent:0; text-indent:0px;"">I’m able to pass<!--EndFragment--></p>"	puedo pasar					